9111111111115517
EAAAAAAAAAA8152B
9284002C2C028102
E803AA8501282AAA
92A86C012EEE802A
AAC07FAEAFFFAAAA
80103FC5057FA86E
AAAAAFFFAFFF8417
C044017FAFD50107
BA91283FAFFFAA83
842A82850795002A
8100280101052AAA
AAAA86AAAA814042
80002902C028103E
EEEEEEEC7EEEEEC7

0,0
15,0
EEEEEEEEEEEEEEE
