9111111111115153
AAEAAAAAEAA8383A
A83EAAA83EAAAAEE
EAEBEAAA83AAEC57
D0103EAAAEEC1113
92AAAFAAAFFFAAEA
AAAEAFEE857FAE92
AA83AFFFAFFF87EE
AEEAC57FAFD56953
813C117FEFFF903A
AE83EC179797AAAA
83A853ED05456EAA
AAE83811011117EA
AE92EAEAEAAA813A
ED6C7ED47EEEEEEE

0,0
15,14
ESSSSSWSSSSEESESEESEEENEEEENNENEESSSSSS
